20,5,1,

01,02,03,01,03,01,02,02,02,03,04,04,06,06,11,11,16,16,18,18,
07,08,09,13,15,07,08,08,08,09,04,04,06,06,11,11,16,16,18,18,
13,14,15,16,16,07,08,08,08,09,05,05,10,10,12,12,17,17,16,16,
16,16,16,16,16,07,08,08,08,09,05,05,10,10,12,12,17,17,16,16,
16,16,16,16,16,13,14,14,14,15,16,16,16,16,16,16,16,16,16,16,
